####################
#E~~#######o~~~~####
###~##~~~##~##~#####
###~##~#~##~##~#####
###~~~~#~##D##~~~~##
###~###~L~~~#####~##
###~###~###~#####~##
###l###p###~###m#~##
###########~###~#~##
##########~~###~#~##
##HO~~~~~~~####~P~##
###~#############~##
###~M~~g###~~~###~##
#~~~#######H#~~v#~##
#~###############~##
#~###########~~~~~##
#~##~~~~~~###~######
#~##~####~###V~~~###
#~G~~####e######~~E#
####################
