####################
#g#v~~~~~##e~~~##~E#
#~###~##~#####~##~##
#~###~~~~#~~~#~##~##
#~######~#~#~#D~~~##
#~~~~~##~#~#~####~##
##~##~#~~~R#~~d##~##
##~~###~#~#######M##
###V~~~~#~~~~~~##~##
#y#####~#~####~##H##
#~#####~#r#~~~~~~~##
#~#~~~~~#~#~###~####
#~#~#~###~#~###~#m~#
#~#~#~#~~~~~~~#~##~#
#~#~#~#~#####~#~#H~#
#~#~#~#~#o~~#~#~##~#
#~#~#~#~#~#L#~#O~~~#
#~Y~#~#~###~########
#~###~G~~~~~~~~~~~l#
#S##################
