####################
#H~~~~~~~S#####~~~y#
#~#############~##~#
#~#############~##~#
#~#############~##~#
#~####~~~~R~~~~~##~#
#~####~###########~#
#~####y###########~#
#~####~###########~#
#~#########H~~~~v~~#
#r################~#
#~################~#
#~################~#
#~##############~~~#
#~#######~~y~~####~#
#~###########~####~#
#~###########~##~#~#
#~####~~E####~##~#~#
#~####~######~##~#~#
#~~~~~~###~~~~~~V~~#
####################
