####################
#S~~#######o~~~~####
###~##~~~##~##~#####
###~##~#~##~##~#####
###~~~~#~##D##~~~~##
###~###~L~~~#####~##
###~###~###~#####~##
###l###r###~###m#~##
###########~###~#~##
##########~~###~#~##
##HO~~~~~~~####~R~##
###~#####d#######~##
###~M~~g###~~~###~##
#~~~#######H#~~v#~##
#~###############~##
#~###########~~~~~##
#~##~~~~~~###~######
#~##~####~###V~~~###
#~G~~####e######~~E#
####################
