####################
#H~~~~~~~S#####~~~Y#
#~#############~##~#
#~#############~##~#
#~#############~##~#
#~####~~~~R~~~~~##~#
#~####~###########~#
#~####e###########~#
#~####~###########~#
#~#########H~~~~v~~#
#r################~#
#~################~#
#~##############~~~#
#~#######~~y~~####~#
#~###########~####~#
#~###########~##~#~#
#~####~~E####~##~#~#
#~####~######~##~#~#
#~~~~~~###~~~~~~V~~#
####################
